111111111
10010C001
100001111
1P0000E01
111111111