111111111
100001011
1C0010111
1100P0011
1010000E1
111111111