111111111
100001011
100010111
1100P0011
1010000E1
11111111E